21
132
I I I I I I I I I I I I I I I I I I I I I I I I I I I I I I I I I I I I I I I I I I I I I I I I I I I I I I I I I I I I I I I I I I I I I I I I I I I I I I I I I I I I I I I I I I I I I I I I I I I I I I I I I I I I I I I I I I I I I I I I I I I I I I I I I I I I
I L N N N N N N O 0 0 0 0 0 0 0 0 0 0 0 0 0 0 0 0 0 0 0 0 0 0 0 0 0 0 0 0 0 0 0 0 0 0 0 P R R R R R R R R S 0 0 0 0 0 0 0 0 0 0 0 0 0 0 0 0 0 0 0 0 0 0 0 0 0 0 0 0 0 0 0 0 0 0 0 0 0 0 0 0 0 0 0 0 0 0 0 0 0 0 0 0 P R R R R R R R R S 0 0 0 0 0 0 0 0 0 0 0 0 0 0 0 I
I P R R R R R R S 0 0 0 0 0 0 0 0 0 0 0 0 0 0 0 0 0 0 0 0 0 0 0 0 0 0 0 0 0 0 0 0 0 0 0 P R R R R R R R R S 0 0 0 0 0 0 0 0 0 0 0 0 0 0 0 0 0 0 0 0 0 0 0 0 0 0 0 0 0 0 0 0 0 0 0 0 0 0 0 0 0 0 0 0 0 0 0 0 0 0 0 0 P R R R R R R R R S 0 0 0 0 0 0 0 0 0 0 0 0 0 0 0 I
I P R R Q R R R S 0 0 0 0 0 0 0 0 0 0 0 0 0 0 0 0 0 0 0 0 0 0 0 0 0 0 0 0 0 0 0 0 0 0 0 P R R R R R R R R S 0 0 0 0 0 0 0 0 0 0 0 0 0 0 0 0 0 0 0 0 0 0 0 0 0 0 0 0 0 0 0 0 0 0 0 0 0 0 0 0 0 0 0 0 0 0 0 0 0 0 0 0 P R R R R R R R R S 0 0 0 0 0 0 0 0 0 0 0 0 0 0 0 I
I P R R R R R R S 0 0 0 0 0 0 0 0 0 0 0 0 0 0 0 0 0 0 0 0 0 0 0 0 0 0 0 0 0 0 0 0 0 0 0 P R R R R R R R R S 0 0 0 0 0 0 0 0 0 0 0 0 0 0 0 0 0 0 0 0 0 0 0 0 0 0 0 0 0 0 0 0 0 0 0 0 0 0 0 0 0 0 0 0 0 0 0 0 0 0 0 0 P R R R R R R R R S 0 0 0 0 0 0 0 0 0 0 0 0 0 0 0 I
I P R R R R R R S 0 0 0 0 0 0 0 0 0 0 0 0 0 0 0 0 0 0 0 0 0 0 0 0 0 0 0 0 0 0 0 0 0 0 0 P R R R R R R R R S 0 0 0 0 0 0 0 0 0 0 0 0 0 0 0 0 0 0 0 0 0 0 0 0 0 0 0 0 0 0 0 0 0 0 0 0 0 0 0 0 0 0 0 0 0 0 0 0 0 0 0 0 P R R R R R R R R S 0 0 0 0 0 0 0 0 0 0 0 0 0 0 0 I
I P R R R Q R R S 0 0 0 0 0 0 0 0 0 0 0 0 0 0 0 0 0 0 0 0 0 0 0 0 0 0 0 0 0 0 0 0 0 0 0 P R R R R R R R R S 0 0 0 0 0 0 0 0 0 0 0 0 0 0 0 0 0 0 0 0 0 0 0 0 0 0 0 0 0 0 0 0 0 0 0 0 0 0 0 0 0 0 0 0 0 0 0 0 0 0 0 0 P R R R R R R R R S 0 0 0 0 0 0 0 0 0 0 0 0 0 0 0 I
I P R R R R R R S 0 0 0 0 0 0 0 0 0 0 0 0 0 0 0 0 0 0 0 0 0 0 0 0 0 0 0 0 0 0 0 0 0 0 0 P R R R R R R R R S 0 0 0 0 0 0 H H H H H 0 0 0 H H H H H 0 0 0 H H H H H H H 0 0 0 0 0 L O 0 0 0 0 0 0 0 0 0 0 0 0 0 0 0 0 P R R R R R R R R S 0 0 0 0 0 0 0 0 0 0 0 0 0 0 0 I
I P R R R R R R S 0 0 0 0 L N N N N O 0 0 0 0 0 0 0 0 0 0 0 0 0 0 0 0 0 0 0 0 0 0 0 0 0 P R R R R R R R R S 0 0 0 0 0 0 0 0 0 0 0 0 0 0 0 0 0 0 0 0 0 0 0 0 0 0 0 0 0 0 0 0 0 0 P S I I I I 0 0 I I I I I I I I I I P R R R R R R R R S 0 0 0 0 0 0 0 0 0 0 0 0 0 0 0 I
I P R Q R R R R S 0 0 0 0 A B B B B D 0 0 I 0 0 0 0 L M M M O 0 0 0 0 0 0 0 0 0 0 0 0 0 P R R R R R R R R S 0 0 0 K 0 0 0 0 0 0 0 0 0 0 0 0 0 0 0 0 0 0 0 0 0 0 0 0 0 0 0 0 0 0 P S 0 0 0 0 0 0 0 0 0 0 0 0 0 0 0 0 P R R R R R R R R S 0 0 0 0 0 0 0 0 0 0 0 0 0 0 0 I
I P R R R R R R S 0 0 0 K 0 0 0 0 0 0 0 0 0 0 0 0 0 P R R R S 0 0 L O 0 0 0 0 0 0 0 0 0 P R R R R R R R R S 0 0 0 0 0 0 0 0 0 0 0 0 0 0 0 0 0 0 0 0 0 0 0 0 0 0 0 0 0 0 0 0 0 0 P S 0 0 0 0 0 0 0 0 0 0 0 0 0 0 0 0 P R R R R R R R R S 0 0 0 0 0 0 0 0 0 0 0 0 0 0 0 I
I P R R R R R R S 0 0 0 0 0 0 0 0 0 0 0 0 0 0 0 0 0 P R R R S 0 0 A D 0 0 0 0 0 0 0 0 0 P R R R R R R R R S K 0 0 0 0 0 0 0 0 0 0 0 0 0 0 0 0 0 0 0 0 0 0 0 0 0 0 0 0 0 0 0 0 0 P S I I I I I I I I 0 0 I I I I I I P R R R R R R R R S 0 0 0 0 0 0 0 0 0 0 0 0 0 0 0 I
I A B B B B B B D K 0 0 0 0 0 0 0 0 0 0 0 0 0 0 0 0 P R R R S 0 0 0 0 0 0 L N N N O 0 0 P R R R R R R R R S 0 H 0 0 0 0 0 0 0 0 0 0 0 0 0 0 0 0 0 0 0 0 0 0 0 0 0 0 0 0 0 0 0 0 P S 0 0 0 0 0 0 0 0 0 0 0 0 0 0 0 0 P R R R R R R R R S 0 0 0 0 0 0 0 0 0 0 0 0 0 0 0 I
I 0 0 0 0 0 0 0 0 0 I 0 0 0 0 0 0 0 0 0 0 0 0 0 0 0 P R R R S 0 0 0 0 0 0 A B B B D 0 0 A C C C C C C C C C 0 0 0 0 H H H H H H 0 0 H H H H H H 0 0 0 0 0 0 0 0 0 0 0 0 0 0 0 0 P S 0 0 0 0 0 0 0 0 0 0 0 0 0 0 0 0 P R R R R R R R R S 0 0 0 0 0 0 0 0 0 0 0 0 0 0 0 I
I 0 0 0 0 0 0 0 0 0 0 0 0 L M M M M O 0 0 0 0 0 0 0 P R R R S 0 0 0 0 0 0 0 0 0 0 0 0 0 0 0 0 0 0 0 0 0 0 0 0 0 0 0 0 0 0 0 0 0 0 0 0 0 0 0 0 0 0 0 0 K 0 0 0 K 0 0 0 0 0 0 0 0 P S I I I 0 0 I I I I I I I I I I I A C C C C C C C C D 0 0 0 0 0 0 0 0 0 0 0 0 0 0 0 I
I 0 0 0 0 0 0 0 0 0 0 0 0 A B B B B D 0 0 I I 0 0 0 P R R R S 0 0 0 I 0 0 0 0 0 0 0 0 0 0 0 0 0 0 0 0 0 0 0 0 0 0 0 0 0 0 0 0 0 0 0 0 0 0 0 0 0 0 0 0 0 0 0 0 0 0 0 0 0 0 0 0 0 P S 0 0 0 0 0 0 0 0 0 0 0 0 0 0 0 0 0 0 0 0 0 0 0 0 0 0 0 0 0 0 0 0 0 0 0 0 0 0 0 0 0 I
I 0 0 0 0 0 0 0 0 0 0 0 0 0 0 0 0 0 0 0 0 0 0 0 0 K P R R R S 0 0 0 0 0 0 0 0 0 0 0 0 0 0 0 0 0 0 0 0 0 0 0 0 0 0 0 0 0 0 0 0 0 0 0 0 0 0 0 0 0 0 0 0 0 0 0 0 0 0 0 L M M M M O R S 0 0 0 0 0 0 0 0 0 0 0 0 0 0 0 0 0 0 0 0 0 0 0 0 0 0 0 0 0 0 0 0 0 0 0 0 0 0 0 0 0 I
I 0 0 0 0 0 0 0 0 0 0 0 0 0 0 0 0 0 0 0 0 0 0 0 0 0 P R R R S 0 0 L M M M O 0 0 0 0 0 0 0 0 0 0 0 0 0 0 0 0 0 0 0 0 0 0 0 0 0 0 0 0 0 0 0 0 0 0 0 0 0 0 0 0 0 0 0 0 A B B B B D R S 0 0 0 0 0 0 0 0 0 0 0 0 0 0 0 0 0 0 0 0 0 0 0 0 0 0 0 0 0 0 0 0 0 0 0 0 0 0 0 0 0 I
I 0 X 0 0 0 0 0 0 0 0 0 1 0 0 0 1 0 0 0 0 L N N N O P R R R S 0 0 A B B B D 0 0 0 0 0 0 0 0 0 0 0 0 0 0 0 0 0 0 0 0 0 0 0 H 0 0 0 H 0 0 0 H 0 0 0 I 0 0 0 L M M M M M M M M M O R S 0 0 0 0 0 0 0 0 0 0 0 0 0 0 0 0 0 0 0 0 0 0 0 0 0 0 0 0 0 L O 0 0 0 0 0 0 0 0 0 0 I
I 0 0 0 0 0 0 0 0 0 0 0 0 0 0 0 0 0 0 0 0 A B B B D A B B B D 0 0 0 0 0 0 0 0 0 0 0 0 0 0 0 0 0 0 0 0 0 1 0 0 0 0 I ^ ^ ^ ^ ^ ^ ^ ^ ^ ^ ^ ^ ^ ^ ^ H 0 0 0 A B B B B B B B B B D R S 0 0 0 0 0 0 1 0 0 0 1 0 0 0 1 0 0 0 0 0 0 0 0 0 0 0 0 0 I A D 0 0 0 0 0 * 0 0 0 0 I
I I I I I I I I I I I I I I I I I I I I I I I I I I I I I I I I I I I I I I I I I I I I I I I I I I I I I I I I I I I I I I I I I I I I I I I I I I I I I I I I I I I I I I I I I I I I I I I I I I I I I I I I I I I I I I I I I I I I I I I I I I I I I I I I I I I I